NO img/STONE3.xpm
WE img/STONE2.xpm
SO img/STONE2.xpm
EA img/STONE3.xpm

F 123,25,43
C 141,150,   

        1111111111111111111111111
        1000000000110000000000001
        1011000001110000000000001
        100100000000000000W000001
111111111011000001110000000000001
100000000011000001110111100111111
11110111111111011100000010001
11110111111111011101010010001
11000000110101011100000000001
10000000000000001100000010001
10000000000000000101010010001
11001001110101010111011110111
11110111 11101010010111101001
11111111 11111110111111111111
11111111111110110111111111111
10000000000000000000000000001
11111111111111111111111111111
11111111111111111111111111111